NO ./textures/200.png
SO ./textures/100.png
WE ./textures/50.png
EA ./textures/20.png

F 24,61,61

C 53,47,68

        1111111111111111111111111
        1000000000110000000000001
        1011000001110000000000001
        1001000000000000000000001
111111111011000001110000000000001
100000000011000001110111111101111
11110111111111011100000000001
11110111111111011101010000001
11000000110101011100100010001
10000000000000001100000010001
10000000000000001101010010001
11000001110101011111011110N0111
11110111 1110101 101111010001
11111111 1111111 111111111111
